
F       138, 138, 138
C     56, 56, 56

S ./textures/barrel.XPM

NO         ./textures/greystone.XPM

SO        ./textures/redbrick.XPM
WE       ./textures/colorstone.XPM

EA        ./textures/eagle.XPM
R 1920  1080

111111111111
122202020011
100000000021
100202020021
100000000001
1202020200S1
111111111111